Hosting Company	DB_HOST Value Guess
1and1		 db12345678
AN Hosting	 localhost
A Small Orange	 localhost
BlueHost	 	localhost
DreamHost	 mysql.example.com

GoDaddy	 Go to MySQL and edit the database to find the server name.
HostGator	 	localhost
HostICan	 	localhost
ICDSoft	 	localhost:/tmp/mysql5.sock
IPower	 	username.ipowermysql.com
LaughingSquid	 localhost

MediaTemple GridServer	 internal-db.s44441.gridserver.com
MediaTemple (dv)		 localhost
MegnaHost		 localhost
NearlyFreeSpeech.Net	 username.db
one.com	 localhost
pair Networks		 dbnnnx.pair.com
Rackspace Cloud	 	mysql50-01.wc1.dfw1.stabletransit.com
Yahoo	 mysql	
Hosts with cPanel	 	localhost
Hosts with Plesk		 localhost
Hosts with DirectAdmin	 localhost
Tophost.it	 		sql.your-domain-name.it